000001111100001111100000
000000000000000000000000
000000000000000000000000
000000000000000000000000
000000000000000000000000
100000000000000000000001
100000000000000000000001
100000000000000000000001
100000000000000000000001
100000000000000000000001
100000000000000000000001
000000000000000000000000
000000000000000000000000
000000000000000000000000
000000000000000000000000
000001111100001111100000
