000000111100001111000000
000000000000000000000000
000000000000000000000000
100001000000000000100001
100001000000000000100001
100111000000000000111001
100000000000000000000001
100000000000000000000001
100000000000000000000001
100111000000000000111001
100001000000000000100001
100001000000000000100001
000000000000000000000000
000000000000000000000000
000000000000000000000000
000000111100001111000000
